C 173,216,230

F 100,100,100

NO textures/photos/1.xpm
SO textures/photos/2.xpm
WE textures/photos/3.xpm
EA textures/photos/4.xpm


11111111111111111
10000000000000001
100000000000000W1
10000000000000001
11111111111111111
