C 255,182,193
F 204,0,102

NO textures/photos/pink_brick.xpm
SO textures/photos/pink_brick2.xpm
WE textures/photos/nicole.xpm
EA textures/photos/leila.xpm

11111111111111111111111111111
10001111111111111111111111111
10000000000000000000111100001
10000000000000000000000100001
10000000000000000001000100001
10000000000000000000000100001 
11111000000000000010001000001111111111111
11001110101111101000000100000000000000001
10000000000000000011110000000000000000011
1000000000000000001  111111011111111110111
1000000000000000101  10000101        10111
1001000010000000101  10000001        101
100000000000000N101  10000101        101
1000000000000000001111100010111111111101
1100000000000001101000000000000000000001
1111111111111111111111111111111111111111