
C 173,216,230

F 101,67,33

NO textures/photos/brick3.xpm
SO textures/photos/pink_brick.xpm
WE textures/photos/brick.xpm
EA textures/photos/brick4.xpm



11111111111111111111111111111
10000000001100000000000000001
101100000111000000D0000000001
10010000000000000000000000001
10010000000000000000000000001
1011000001110000000000E000001
10000000001100000000000000001
10000000000000000000000000001
10000000000000000000000000001
1000D000000000000000000000001
1000000000000000000000D000001
10000000000000000000000000001
10000000000000000000000000001
10000000000000000000000000001
11111111111111111111111111111
