C 0,0,102
F 0,51,25
NO textures/photos/wood.xpm
SO textures/photos/wood2.xpm
WE textures/photos/wood3.xpm
EA textures/photos/wood4.xpm

1111111111111111
10000000000000001
1000000000000000011111111111111
10000000000000000000000000000001
11111111111111100000000000000W01
               10000000000000001
1111111111111111011100011111111
10000000000000000000001
10000000000000000000001
1000000000000000111111
1111111111111111
