
EA ./path_to_the_east_texture
NO ./path_to_the_north_texture
SO ./path_to_the_south_texture
WE ./path_to_the_west_texture
F 220,100,0
C 225,30,0



		1111111111111111111111111
		1000000000110000000000001
		1011000001110000000000001
		1001000000000000000000001
111111111011000001110000000000001
100000000011000001110111111111111
11110111111111011100000010001111111
11110111111111011101010010000000001
11000000110100011100001000001111111
10000000000000001100000010001
1000000010000N001101010010001
110000011101010111110111100111
11110111 1110101 1011110100001
11111111 1111111 111111111111