
EA ./path_to_the_east_texture
NO ./path_to_the_north_texture
SO ./path_to_the_south_texture
WE ./path_to_the_west_texture
F 245,245,220
C 137,207,240

		1111111111111111111111111
		1000000000110000000000001
		101100000111000000D000001
		1001000000C00000000000001
111111111011000001110000000000001
100000000011000001110111111111111
11110111111111011100000010001111111
11110111111111011101010010000000001
11000000110100011100001000001111111
1000D000C0D000001100000010001
1000000010000S001101010010001
110000011101010111110111100111
11110111 1110101 1011110100001
11111111 111C111 111111111111
11111111111000111111111111111
111111111110D0111111111111111
11111111111111111111111111111